1111111111
1P00001111
1000001111
100C001111
1111111111
