1111111111
1000000001
1000000001111
1000000001  1
1000000001  1
1000000001111
1000000001
1111111111
