1111111111
1000000011
10000E0011
1000000C11
1111111111
