1111111111111111111
1P0V00000V0000C0001
10E0000CV000V100001
10000000X0V00100001
100V0000V0000100001
100V00V000000100C01
1111111111111111111
