1111111111111111111
100V00000V0000C0001
10E0000CV000V100001
10000P00000V0100001
1000V000V0000100001
100V00V000000100C01
1111111111111111111
