1111111
1P00001
100C001
1000E01
1101111
