1111111111111111111
10E00000000001C0001
1000000000000100001
1000000000000100001
1000000000000100001
10P0000000000100C01
1111111111111111111
