1111111
1000P01
10000C1
1111111
1000001
1000001
10E0001
1000001
1111111
