1111111111111111111
10000000000000C0001
10E0000C00000100001
1000000000000100001
1000000000000100001
10P0000000000100C01
1111111111111111111
